بزم|مونث)سبھا-محفل-مجلس۔)
جابجا|ہرجا-ہرکہیں-ہرمقام پر۔
راغب|مائل-خواہش مند۔
سالم|پورا-صحیح-سلامت۔
فراق|مونث)جدائ-ہجر-فکر۔)
آپڑنآ|آموجود ہونا۔
آپہنچنا|منزل طے کرنا۔
آجانا|سيکھ لينا-پہنج جانا۔
آلگنا|قريب آجانا-پہنج جانا۔
آرہاہے|قريب پہنج جانا۔
آب آجانا|رونق آجانا۔
آب آخرت|غسل ميت۔
آب داری|چمک دمک-جلا۔
آب دان|پانی کا برتن۔
آبدست|طہارت کرلينا۔
آبدندان|دانتوں کی چمک۔
آبرحمت|بارش-بخشش۔
آبرواں|بہتا ہوا پانی۔
آبزمزم|زمزم کاپانی۔
آبوتاب|چمک دمک روشنی۔
آبورنگ|روپ-خوبصورتی۔
آبشرم|شرمندگی کا پانی۔
آبشار|اونچی جگہ سے بہتا ہوا پانی۔
آبشورہ|سمندر کا پانی۔
آبکوثر|حوض  کوثر کا پانی۔
آبوہوا|پانی اور ہوا۔
آباد|بسا  ہوا۔
آپ|خود اپنی ذات۔
آپسداری|رشتہ داری۔
آتا|آنے والا۔
آتے|چلے آنا۔
آج|وقت حاضر۔
آخر|انجام۔
آراستہ|درست کرنا۔
آرام|ٹھراو۔
آساہش|راحت۔
اپنا|خود کا۔
اترجانا|ڈھل جانا۔
اتنا|تعت اد۔
اجلاس|اٹھنے بيٹھنے کي جگہ۔
اچانک|يکا يک۔
اچھا|مناسب۔
احاطہ|گھيراو۔
احترام|عزت-حرمت۔
احتساب|حساب۔
احسان|بھلایی کرنا۔
اخراجات|بہت سے خرچے۔
اخلاص|پاک صاف۔
اخوت|بھا ہی چارہ۔
اذکار|قصے کہانياں۔
ازدواج|شادی کرنا۔
ازل|شروع۔
اس|اشارہ دينا۔
استحصال|حاصل کرنا۔
استحقاق|حق طلب کرنا۔
استحکام|مضبوطی۔
استخارہ|طلب خير۔
استدلال|دليل چاہنا۔
استطاعت|دسترس۔
استعجاب|تعجب-حيرانی۔
استعفا|ترک ملازمت کرن۔
استعمال|کام ميں لانا۔
استقامت|قيام۔
استقبال|خير مقدم۔
استقدام|درپيش ہونا۔
اسلاف|بزرگ۔
اسلحہ|آلات جنگ۔
اسلوب|طريقہ۔
اشاعت|شايع کرنا۔
اشتعال|آگ بھڑکانا۔
اشغال|مشغلے-کام۔
اصرار|تاکيد۔
اصراف|بہت سے خرچ۔
اصل|بنیاد۔
اصلاح|درستی۔
اصول|طور طريقہ۔
اطاعت|تابعداری۔
اعتدال|ميانہ روی۔
اعتراف|تسليم کرنا۔
اعتراض|عيب گوہی۔
اعضاء|بدن کے حصے۔
اعتماد|بھروسے۔
اعجاز|معجزہ۔
اکثر|زيادہ تر۔
باخبر|واقف۔
باضابطہ|قاعدے کے ساتھ۔
باطہارت|وضو کيے ہوے۔
بات|کلام۔
بادشاہت|حکومت۔
بٹاسٹا|لين دين۔
بجلی|برقی قوت۔
بجھنا|مايوس ہونا۔
بچاو|حفاضت۔
بچت|فاءدہ۔
بچھونا|بستر۔
بحث|تکرار۔
بحال|برقرار۔
بخار|بھاپ۔
بختاور|خوش قسمتی۔
بخشش|معافی۔
بد|برا-خراب۔
بدنام|رسوا ہونا۔
بداصل|بے ڈھنگا۔
بداعمال|برے کام کرنے والا۔
بدبو|خراب بو۔
بددمماغ|مغرور-گھمنڈی۔
بدزبان|بدکلام-گستاخ۔
بدساعت|منحوس گھڑی۔
بدسگالی|برا چاہنا۔
بدصورت|بری صورت۔
بدنامی|رسوای۔
برخلاف|برعکس۔
برحق|درست۔
برخاستگی|برفی-رخصت۔
برقرار|زندہ-باقی۔
بروقت|عين وقت پر۔
برابری|مقابلہ۔
برسات|بارش کا موسم۔
برکت|کثرت-نعمت۔
بڑای|عظمت-بزرگی۔
بسر|گزارنا۔
بغلول|احمق-بيوقوف۔
بناوٹ|ساخت-شکل۔
پاس|قبضيت-ملکيت۔
پاسبان|نگہبان-ديکھ بھال۔
پاسداری|خيال-ادب۔
پختہ|ہوشيار-تجربہ کار۔
پرای|غير کی۔
پرستش|عبادت-پوجنا۔
پروردگار|پرورش کرنے والا۔
پروانگی|اجازت۔
پڑوس|ارد گرد-اطراف۔
پڑتال|جانچ۔
پذيرای|قبوليت-منظوری۔
پڑھنا|مطالعہ کرنا۔
پسپردہ|چھپا ہوا۔
پسپا|واپس ہونا-ہٹنا۔
پسند|حسب خواہش۔
پکار|فرياد-دہای۔
پکڑ|گرفت-قبضہ۔
پلٹ|گھماو-گردش۔
پناہ|معافی-امن۔
پنساری|مصالحے بيچنے والا۔
پوچھنا|تلاش کرنا۔
پہلو|طرف-سمت۔
پھنسنا|الجھنا-گرفتار۔
پياس|پانی پينے کی خواہش۔
تباہی|بربادی۔
تبرک|تحفہ۔
تجارت|دکان داری۔
تجربہ|امتحان-پرکھ۔
تحفظ|احتياط-حفاضت۔
تحفہ|پيشکش-سوغات۔
تحمل|برداشت-بردباری۔
تحويل|بدلنا۔
تدارک|سزا-تلافی۔
تدافع|دفع کرنا۔
تذکرہ|ذکر-چرچا۔
ترک|چھٹ جانا۔
ترقی|آگھے بڑھنے۔
تسلسل|سلسلہ-جاری۔
ٹٹولنا|بے ديکھے ڈھونڈنا۔
ٹوپی|مہر کی پوشاک۔
ٹوٹ|شکستگی۔
ٹھاٹبھاٹ|شان وشوکت۔
ٹھکانا|جگہ-مقام۔
ٹھنڈا|سردی-خشکی۔
ٹھرانا|طے کرنا-مقرر کرنا۔
ثابت|تصدیق شدہ, مانا ہوا۔
ثاقب|روشن-چمکدار۔
ثانی|مانند-نظیر۔
پائداری|مظبوط-ثبات۔
ثبوت|دلیل-سچائی۔
ثمر|کامیابی۔
ثمرہ|بدلا-فاہدہ۔
ثمن|قیمت-قدر۔
ثقافت|تہذیب-کلچر۔
ثقاہت|متانت-سنجیندگی۔
ثقیل|بھاری-بوجھل۔
ثقیف|عقلمند-چالاک۔
ثناہ|تعریف کرنا۔
ثواب|انعام-اجرت۔
ثیاب|لباس-پوشاک۔
جابر|ظالم۔
جابھی|بيزاری۔
جابول|جواب کی جمع۔
جابجا|جگہ جگہ۔
جالہنا|ٹہرنا۔
جاترا|ميل جول۔
جاٹ|ايک ذات۔
جاجم|چھاپے کا فرش۔
جاچ|ظلم و ستم۔
جاٹھ|لٹھ کی ايک قسم۔
جارو نظر|معشوق۔
جاچک|جانچنے والا۔
جادہ|سڑک۔
جاڑا|سردی۔
جازب|جزپ کرنے والا۔
جازم|جزم رينے والا۔
جاسوسی|مخبری۔
جاز|ايک طرح کا نغمہ۔
جارح|زخمی کرنے والا۔
جاکڑ|واپسی کی شرط پر خريدی ہوی چيز۔
جاروب|جھاڑو۔
جاکھن|کنويں کا چاک۔
جاکی|چابک سوار۔
جاگرتی|شعور۔
جاگت|پہرہ دينا۔
جالدار|پھندے دار۔
جاگو|ہوشيار۔
جام|پيالہ۔
جالی|جھلی۔
جامہ|پوشاک۔
جامن|پھل۔
جامگی|بندوق کا ٹوڑا۔
جان|روح۔
جامع|مکمل۔
جامعيت|ہمہ گيری۔
جانکار|شناسا۔
جانکے|ارادہ کر کے۔
جانپہچان|واقفيت۔
جاناں|مجبوب۔
جانبرار|حمايتی۔
جاوداں|ہميشہ۔
چاب|چانبا کا امر۔
چابک|چست۔
چا|چاہ۔
چابکی|چالاکی۔
چابنا|چبانا۔
چاٹنا|چٹ کرنا۔
چاٹيا|چٹوڑا۔
چادر|مربع۔
چاٹی|دودھ کی ہانڈی۔
چاپاتی|روٹی۔
چابی|کنجی۔
چاپٹ|بھوسی۔
چاپ|کمان۔
چاتر|چالاک۔
چاپلوسی|خوشامدی۔
چادرا|بڑی چادر۔
چاند|ايک سيارا۔
چارتگ|سرپٹ۔
چاربند|پشت کے چاروں جوڑ۔
چار|گنتی۔
چارٹوک|چوکھنڈا۔
چارجانی|بدکار۔
چارجامہ|کپڑے کا زين۔
چارتال|چوتالا۔
چارتار|چار جوڑے۔
چارا|گھاس۔
چومنا|بوسہ دينا۔
چاشنی|پت۔
چارٹ|نقشہ۔
چارکول|کوءلہ۔
چمار|جاہل۔
چارولی|مغز گری۔
چاق|ہوشيار۔
چاقوچوبند|چست۔
چاقو|آلہ۔
چاک|ٹکڑے۔
چارہ|علاج۔
چکر|گھومنا۔
چوٹ|زخم۔
چاکنا|چکھنا۔
چاکسو|سياہ بيج۔
حاجات|ضروريات۔
حادثہ|سانحہ-واقعہ۔
حاذق|تجربہ کار۔
حارث|کاشتکار۔
حارج|مزاحمت کرنے والا۔
حاسد|دشمن۔
حاصل|پيدوار-نتيجہ۔
حاضر|موجود-تيار۔
حافظ|حفاظت کرنے والا۔
حاکم|سردار۔
حال|کيفيت۔
حامد|تعريف کرنے والا۔
حامذ|ترش-کھٹا۔
حامل|بوجھ اٹھانے والا۔
حامی|مددگار۔
حاوی|احاطہ کرنے والا۔
حاءل|روکنے والا۔
حبیب|دوست-پیارا۔
حتمی|پکا۔
حجاب|پردھ-نقاب۔
حجت|بحث-تکرار۔
حجرہ|خلوت حانہ۔
حد|انتہاء۔
حذاقت|عقلمندی۔
حرارت|گرمی-شدت۔
حرج|نقصان۔
حرص|ہوس۔
حرکت|چال۔
حزب|گروہ-جماعت۔
حزین|غمگین۔
حساب|شمار۔
حساس|زیادہ محسوس کرنے والا۔
حسرت|آرزو۔
حسن|نیک-اچھا۔
حشر|قیامت۔
حشمت|نوکرچاکر۔
حشیش|بھنگ۔
حصہ|شریک۔
حصین|محفوظ۔
حصار|احاطہ-گھیرا۔
حضار|حاضرین۔
حفاضت|نگرانی۔
حطاب|لکڑہارا۔
حق|درست۔
حقوق|فراءض۔
حقیقت|اصل-جڑ۔
حکم|ہدایات۔
حکمت|عقل۔
حلف|عہد-پیمان۔
خاتم|انجام۔
خاتون|معزز عورت۔
خادم|نوکر-غلام۔
خارج|باہر نکلا ہوا۔
خارشی|کھجلی والا۔
خارق|جمع خوراق۔
خازن|خزانچی۔
خاشع|عاجزی۔
خاص|عمدہ-منتخب۔
خاطب|مقرر۔
خاطر|واسطے۔
خاک|مٹی-دھول۔
خالق|پیدا کرنے والا۔
خامس|پانوچاں۔
خاموش|چپ-ساکت۔
خاندان|قبیلہ-گھرانہ۔
خانماہ|مال ومتاع۔
خانہ بدوش|آوارہ۔
خاوند|شوہر۔
خباثت|نا پاکی-گندگی۔
خبر|اطلاع-آگاہی۔
خبردار|ہوشیار۔
ختم|مکمل۔
خجستہ|خوش قسمت۔
خجلت|شرمندہ۔
خدشہ|خطرہ۔
خدمات|کار گزاریاں۔
خردماغ|ضدی۔
خراش|چھیلن-رگڑ۔
خرافات|فضول بکواس۔
خرچ|لاگت۔
خسارہ|نقصان۔
خساست|کمینگی۔
خستہ|بد حالی۔
خسیس|کنجوس۔
خصلت|سیرت۔
خضوع|عاجزی۔
خضیب|رنگین۔
خفی|جھپا ہوا۔
خفیف|کم ظرف۔
خلاص|رہاءی۔
خلاف|برعکس۔
خلل|خرابی۔
خلوت|علیہدگی۔
خمدم|ہمت-جوش۔
خمار|کیفیت۔
خمیازہ|بدلہ۔
خواری|رسواءی۔
خواست|جاہ۔
خواہ|خواہش۔
داب|بوجھ۔
دال|اناج۔
داتا|دينے والا۔
دابہ|چوپایہ۔
داتاپن|سخاوت۔
داتر|بڑا درانتی۔
داتن|مسواک۔
داٹن|گھناپن۔
داٹی|ڈانٹ۔
داٹ|سخت۔
دلج|اندھيرا۔
داخل|گھسنا۔
دادسخن|شعر کی تعريف۔
داد|تعريف۔
دادوستد|خريدوفروخت۔
دادا|بوڑھا۔
دادرس|فرياد سننے والا۔
دادخواہی|نالش۔
دادر|مينڈک۔
دادسرا|سسر کا باپ۔
دار|جگہ۔
دارستش|چار کونے۔
دارباز|نٹ۔
دم|جان۔
دارومدار|انہصار۔
داربست|لکڑی۔
دارابی|رسی۔
داروگير|مشکلدارکش|جلاد۔
دارالعمل|عمل کی جگہ۔
دارا|بادشاہ۔
دارو|شراب۔
دارفلفل|فلفل دراز۔
داراشرع|کچہری۔
دارالعوض|سزا کی جگہ۔
داراسرور|خوشی ک۔
دارالفنون|کالج۔
دارالقضا|قاضی کی جگہ۔
داروغہ|نگران۔
داستان|کہانی۔
ڈاٹنا|ڈرانا-ڈھمکانا۔
ذات|حقیقت۔
ذاءقہ|مزہ۔
ذانب|پیچھے چلنے والے۔
ذبح|گلا کاٹنا۔
ذخیرہ|خزانہ۔
ذریعہ|وساءل۔
ذکر|تذکرہ۔
ذلت|توہین۔
ذمام|حق-عزت۔
ذمہ دار|جوابدہ۔
ذوق|شوق۔
ذہین|تیز فہم۔
راب|گنے کا رس۔
رابطہ|واسطہ۔
رابڑی|ربڑی۔
را|ناگہانی۔
رات|ايک پہر۔
رابع|چوتھا۔
راپٹر|بنجر۔
راپٹا|ٹھپڑ۔
رابعہ|چوتھی۔
راپی|راپنی۔
راتنا|سرخ رنگنا۔
راج|حکومت۔
راتا|لال۔
راتب|کتے بلی۔
رواج|روايت۔
راجکما|راجا۔
راجس|مالک۔
راجع|رجوع کرنے والا۔
راجائ|اميری۔
راجح|فاءق۔
راجل|پيادہ۔
راجوٹ|حکمرانی۔
راجی|ساءل۔
راجے|مزدور۔
راجيو|ہرن۔
راچھ|اوزار۔
رازجو|تلاش کرنيوالا۔
رازداں|واقفکار۔
راچھس|راکشش۔
راح|مزے اڑانا۔
راحت|قرار۔
راز|خفيہ بات۔
راس|سازگار۔
راحتی|کيف۔
راحل|مسافر۔
راحم|رحم کرنے والا۔
راد|مواد۔
رادفت|جو بعد ميں آۓ۔
راڑ|فساد۔
راسخ|اٹل۔
راسو|نيولا۔
راسی|بے پرواہ۔
راست|سيدھا۔
راشی|رشوت لينے دينے والا۔
رباط|مسافر خانہ۔
رتبہ|مرتبہ۔
رجال|لوگ۔
رجحان|توجہ۔
رجعت|باز گشت۔
رجوع|واپس ہونا۔
رچانا|پھیلانا۔
رحلت|روانگی۔
رحم|بخشش۔
رخ|جانب۔
رخسار|گال۔
رخصت|روانگی کی اجازت۔
رذیل|کمینہ۔
رزم|جنگ۔
رسان|نرمی۔
رسال|پہچانے والے۔
رستگاری|انجام۔
رستم|پہلوان۔
رسد|قسمت۔
رسوا|بے عزتی۔
رسوخ|قیام۔
رسید|رساہی۔
رشک|رقابت۔
رشوت|ناجاہز چیز۔
رشی|درویش۔
رشید|تعلیم یافتہ۔
رضا|خوشی۔
رعایا|محکوم لوگ۔
رعب|دبدبہ۔
رعد|گڑگڑاہٹ۔
رعشہ|کپکپی۔
رعنا|خوش و خرم۔
رغبت|آرزو۔
رفاقت|دوستی۔
رفاہیت|بھلائ۔
رفت|روانگی۔
رفتار|روش۔
رفع|باز رہنا۔
رفعت|ترقی۔
رفق|نرمی۔
رقابت|مخالفت۔
رفبہ|غلام۔
زاج|سجی۔
زاد|جنم ہونا۔
زاہد|پرہیزگار۔
زاہق|مضبوط۔
زبان|بات کرنا۔
زبردستی|ظللم سے۔
زبر|فاتح۔
زحمت|تکلیف۔
زخم|نقصان۔
زدہ حال| پریشان حال۔
زرمنافع|فاءدہ۔
زرنقد|نقد روپیہ۔
زراعت|کاشتکاری۔
زشت|بدنما۔
زعیم|سردار۔
زلزلہ|زمین کا کانپنا۔
زمانہ|وقت۔
زندان|قید خانہ۔
زندقہ|منافقت۔
زوال|گھاٹا۔
زیرنظر|نگاہ میں۔
زیروبم|اونچاں۔
زیرک|عقلمند۔
زیست|زندگی۔
زیغ|پھر جانا۔
زیل|باریک کی آواز۔
زینت|خوبصوررت۔
زینہ|سیڑھی۔
زینھار|ہرگز کبھی نہیں۔
زیور|زیب و زینت۔
سابق|اگلے وقت کا۔
ساتر|چھپانے والا۔
ساتھ|ہمراہی-شرکت۔
ساجد|سر جھکانے والا۔
ساجن|خاوند-شوہر۔
ساحر|جادوگر۔
ساحل|سمندر کا کنارہ۔
ساخت|بناوٹ۔
سادگی|بھولا پن-سیدھا پن۔
ساز|جنگی ہتھیاڑ۔
سازشی|سازش کرنے والا۔
سازگار|مناسب۔
ساعت|لمحہ۔
سافل|کمینہ۔
ساقط|مسترد۔
ساکن|قاءم رہنے والا۔
ساکھ|اعتبار۔
سامان|ضروضی چیزیں۔
سامراج|نضامی حکومت۔
سامعین|سننے والا۔
سامنا|ملاقات۔
سامی|بلند۔
سانحہ|حادثہ۔
سایہ|چھاوں۔
سب|تمام۔
سبب|وجہ۔
سبقت|فوقیت۔
سپاٹ|صاف۔
سپرد|سونپا ہوا۔
ستم|جبر۔
ستیزہ|لڑای جھگڑا۔
سجانا|آراستہ کرنا۔
سچ|درست۔
سحر|فجر۔
سخت|ٹھوس۔
سخن|کلام۔
سخی|فراخ دل۔
سخیف|بیہودہ۔
سرتاج|آقا۔
سرحد|انتہاء۔
سرغنہ|سردار۔
سرفدا|جان قربان۔
سرفراز|کامیابی۔
سرقلم|سر کاٹنا۔
سرکش|بے وفا۔
سرگرداں|پريشان۔
سرگرمی|محنت۔
سرگزار|جان دینے والا۔
سرگشتگی|مصیبت۔
سرگوشی|غیبت۔
سرمحفل|سب کے سامنے۔
سرمست|نشے میں چور۔
سرمیدان|مقابلے۔
سرنام|نامور۔
سروکار|غرض۔
سرہنگ|سپاہی۔
سرخرو|کامیابی۔
سردمزاج|بےمروت۔
سرسری|معمولی۔
سرشاری|مستی۔
شاخچہ|تہمت۔
شاد|خوش,مسرور۔
شاداب|سرسبز۔
شارع|بڑا راستہ۔
شاستر|حکم فرمان۔
شاطر|چالاک۔
شاغل|مصروف۔
شافی|صحت دینے والا۔
شاکر|شکر کرنے والا۔
شاکل|مشابہت۔
شاکی|شکایت کرنے والا۔
شامت|برائ۔
شامل|اکٹھا ملا ہوا۔
شان|عظمت,شوکت۔
شانت|مطمءن۔
شاہ|سلطان۔
شاہد|گواہ۔
شب|رات۔
شباب|شروع,آغاز۔
شباہت|مطابقت۔
شبد|قاءدہ و زبان۔
شستاب|فورا۔
شستال|بے قراری۔
شستاع|بدکار۔
شجاعت|بہادری,دلیری۔
شجرہ|نسب نامہ۔
شدت|کثرت۔
شدید|مشکل۔
شر|جھگڑا۔
شرافت|بزرگی۔
شراکت|حصہ داری۔
شرط|قول وقرار۔
شرع|سیدھا راستہ۔
شرم|حیا۔
شرمسار|نادم۔
شروط|عہد۔
شریف|تہذیب یافتہ۔
شعاع|روشنی,چمک۔
شفا|تندرستی۔
شفاف|صاف۔
شفقت|مہربانی۔
شفیع|شفاعت کرنے والا۔
شقاوت|بدبختی۔
شکر|احسان مند۔
شکست|ہار۔
شکیب|بردباری۔
شگون|نیک انجام۔
شمار|گنتی۔
شناخت|پہچان۔
شوخی|شرارت۔
شوریدگی|پریشانی۔
صابر|صبر کرنے والا۔
صالح|نیک-پرہیزگار۔
صامت|خاموش-چپ چاپ۔
صبر|برداشت-تاتل۔
صبیح|گورا-خوبصورت۔
صبور|گنہگاروں پر نرمی کرنے والا۔
صحرا|بیابان-ریگستان۔
صحیح|درست-پورا۔
صحن|آنگن۔
صدقہ|خیرات-اتارہ-قربان-بدولت۔
صدمہ|دھکا-تکلیف۔
صدا|آواز۔
صرف|اکیلا-فقط۔
صریح|صاف-علانیہ۔
صریر|قلم چلنے کی آواز۔
صعوبت|تکلیف-مصیبت۔
صعود|بلندی پر چڑھنا۔
صغر|چھٹائ-چھوٹاپن۔
صف|قطار-فرش۔
صفت|تعریف-خاصیت-وہ اسم جس سے کسی چیز کی خاصیت معلوم ہو۔
صفیر|پرندوں کی آواز-سیٹی۔
صلا|پکار-دعوت۔
صلاح|مشورہ-راۓ۔
صلاحیت|سمجھ-اہلیت۔
صمیم|سچا-مخلص۔
صنف|نوع-جنس-قسم۔
صناع|بہت بڑا کاریگر۔
صنعت|کاریگری-دستکاری۔
صواب|نیکی-درستی۔
صورت|شکل-تصویر-تدبیر۔
صورتحال|معاملہ-کیفیت۔
صہبا|ایک قسم کی لال شراب۔
صیقل|صفائ-چمک۔
صیاد|شکاری۔
صید|شکار-وہ جانور جس کا شکار کریں۔
صوری|ظاہری۔
صوم|روزہ۔
صلوۃ|نماز۔
صفا|پاک-کھرا-مکہ شریف کی ایک پہاڑی۔
صراف|مہاجن-ساہوکار۔
صرصر|آندھی-جھکڑ۔
صبح|سویرا-سحر۔
صحافی|اجبارنویس۔
صادق|سچا-موزوں۔
صاف|کھرا-خالص-اجلا-قطعی-واضح-ٹھیک۔
صراحت|تشریح-وضاحت۔
صوفی|اونی کپڑا پہننے والا-متقی۔
صنم|بت۔
صباحت|گوراپن۔
صحرائ|جنگلی-بیابانی۔
ضالبط|ضبط کرنے والا۔
ضابطہ|قانون-عملدرآمد-آئین۔
ضامنی|کفالت-ذمہداری۔
ضائع|برباد-اکارت-نکما-غارت۔
ضال|گمراہ-بھٹکا ہوا۔
ضبط|انتقام-نبدوبست-حوش کی روک تھام۔
ضحک|ہنسنا-ایران کا ایک ظالم بادشاہ۔
ضحاک|ہنسنے والا۔
ضخامت|جسامت-حجم-لمبائ،چوڑائ اور موٹائ۔
ضخیم|جسیم-موٹا۔
ضد|ہٹ-اصرار-سینہزوری-مخالف-الٹ-برعکس۔
ضدی|ہٹی-شرکش۔
صدین|دو برعکس جیزیں۔
ضراب|لڑنا-تلوار مارنا۔
ضربالمثل|کہاوت-بیان کرنا-بےمثل-اکھان۔
ضرر|نقصان-زیان-دکھ۔
ضرور|لازم۔
ضرورت|حاجت-کمی۔
ضریح|قبر-گور۔
ضعف|کمزوری-نقاہت-ناتوانی۔
ضعیف|کمزور-ناتوان-بوڑھا۔
ضعیفالعقل|پاگلپن-کمعقل-احمق-بےوقوف۔
ضعیفالحال|کمزورحال-پریشانحال-مفلس۔
ضلالت|گمراہی-تباہی-گناہ-خطا۔
ضلع|وہ حصہ جہاں صاحب ڈپٹیکمشنر کا مقام ہو-پسلی۔
ضلعداری|ضلعدار کا عہدہ-کام۔
ضم|پیش۔
صماد|لیپلگانا-مرہم۔
ضمانت|کفالت-ذمہداری۔
ضمیر|وہ لفظ جو ظاہر اسم کے قائمقام ہو-دل-بھید-خیالی-اندیشہ-جو دل میں ہو۔
ضو|سورج کی روشنی۔
ضوفشاں|روشنی ڈالنے والا۔
ضوابط|ضابط کی جمع۔قوانین۔
ضواحک|سامنے کے چار دانت۔
ضیا|روشنی-چمک۔
ضیافت|مہمانی-دعوت۔
ضیغم|شیر-درندہ۔
ضیف|مہمان۔
ضیق|تنگی۔
ضیقالنفس|سانس تنگی سے آنے کی بیماری-دمہ۔
ضعفبصارت|آنکھوں کی کمزوری-کم نظر آنا۔
طاب|خوشبو-عمدہ۔
طارع|چھایا ہوا-غالب۔
طاعت|تابعداری-بندگی-فرمانبرداری۔
طاقت|بل-توانائ-زور۔
طبعیت|مزاج-خصلت-عادت۔
طبیب|ڈاکٹر-حکیم۔
طبعی|ذاتی-اصلی-نیچرل۔
طبق|تھال-سرپوش-رکابی-منزل۔
طرار|تیزذبان-چالاک-جیبکترا-بدمعاش۔
طرب|خوشی-دللگی۔
طرح|طریقہ-ڈھنگ-وضع۔
طرز|ڈھنگ-طریقہ-انداز۔
طشت|تھال۔
طشتازبام|صریح-آشکارا۔
طشتچوکی|ایک قسم کی امیری یا خانہپاٹ۔
طشتری|پرچ-رکابی۔
طعام|کھانا۔
طعمہ|خوراک-لقمہ-گوشت وغیرہ جو شکار کو پکڑنے کے لیے اگاتے ہیں۔
طعن|بولی-ملامت۔
طعنہ|طنز-نیزہ مارنا۔
طغرا|شاہی مہر۔
طغراق|کنپٹی کا گھونہ۔
طغیان|جوار-مدوجزر۔
طفل|بچہ-شیرخواربالک۔
طفیل|واسطہ-سبب۔
طفیلی|بن بلاۓ دعوت میں چلے جانا۔
طفیلیاں|خوشامد-پچھ لگ۔
طلا|سونا۔
طلاق|زوجیت سے خارج کر دینا۔
طلب|چاہت-خواہش-تنخواہ۔
طلوع|چڑھنا-نکلنا-بلندہونا۔
طمانچہ|تھپڑ۔
طمانیت|سکون قلب۔
طمع|لالچ-حرص-چاہت۔
طمنچہ|پستول۔
طناب|رسی-خیمہ کی ڈور۔
طنازہ|نخرے کرنے والا-ناز سے چلنے والا۔
طنبورہ|چھ تار کا ستار۔
طنز|طعنہ-بولی-تمسخر چھیڑ۔
طواف|چاروں طرف گھومنا۔
طوالت|لمبائ-زیادتی-درازی۔
طور|ڈھنگ۔
طوفان|پانی کی زیادتی-نل آندھی غبار تہمت۔بہتان۔
طوق|گلوبند-ہار-زنجیر۔
طہارت|پاکیزگی-صفائ
طہور|پاک۔
طیارہ|ہوائ جہاز۔
طیب|حلال-پاک۔
طنیت|سرشت-نیچر-ضمیر۔
طیش|جوش-غضب۔
طیار|آمادہ-آراستہ
ظالم|ظلم کرنے والا-بےانصاف-انیائ۔
ظاہر|کھلا ہوا-صاف۔
ظاہرا|وضاحت سے-بظاہر۔
ظاہری|بیرونی-پرائ-اوپری۔
ظرافت|خوشطبعی-ہنسی-ٹھٹھا-چہل۔
ظرف|برتن-گنجائش-سمائ-حوصلہ۔
ظریف|ٹھٹھےباز-دللگی باز-ٹھٹھولی-مسخرا۔
ظروف|ظرف کی جمع-برتن۔
ظفر|کامیابی-جیت-فتح۔
ظفریاب|فتحمند-کامیاب۔
ظلل|سایہ-چھاوں۔
ظللظلیل|مستقل-مکمل-سایہ۔
ظلال|سایہدار جگہ۔
ظلام|تاریکی-ظلمات۔
ظلم|بےانصافی-زیادتی-زبردستی۔
ظلمات|ظلمت کی جمع-اندھیرے-تاریکیاں۔
ظلمت|اندھیرا-ظلم-پسند۔
ظلوم|نہایت ظالم-بہت ظلم کرنے والا۔
ظن|گمان-خیال-راۓ۔
ظنغالب|یقین-پختہ راۓ۔
ظنفاسد|شکوشبہ-بدظن۔
ظواہر|زمین کی بلندیاں۔
ظہر|پیٹھ-پشت-تیسرا پہر۔
ظہور|ظاہر ہونا۔
ظہیر|مددگار-دوست۔
عابد|عبادت کرنے والا-دیندار-پرہیزگار۔
عاجز|مسکین-تھکاماندہ-مجبور۔
عادت|دستور-سبھاو۔
عبادت|بندگی-اطاعت۔
عبارت|طرزکلام-مضمون۔
عبرت|نصیحت۔
عتاب|غصہ-غضب-ڈانٹ۔
عتیق|قدیم-پرانا۔
عداوت|دشمنی-بیر۔
عدل|انصاف۔
عدیل|ناپید-نیستونابود۔
عذاب|سزا-تکلیف-دکھ-مصبت۔
عذار|رخسار-گال۔
عذب|میٹھا-خوشگوار۔
عرصہ|میدان-فاصلہ-وقت۔
عرض|درخواست-چوڑائ۔
عروج|چڑھائ-اٹھان-بلندی۔
عزت|شان-آبرو-رفعت۔
عزلت|گوشہ تنہائ۔
عزیمت|ارادہ-مقصد۔
عسکر|لشکر-فوج۔
عس|شہید۔
عشق|پیار-محبت۔
عشوہ|ناز-نخرہ۔
عصا|لاٹھی-چھڑی-سونٹا۔
عصر|رمانہ-وقت-عمر-شام سے پہلے کا وقت-شام کی نماز۔
عضد|مدد کرنا۔
عضو|جوڑ۔
عطا|بخشش-عنایت۔
عطر|خشبو۔
عظم|بڑائ۔
عظمت|شان-بڑائ۔
عفت|نیکی-پاکیزگی-پاکدامنی۔
عفو|معافی-بخشش-درگزر۔
عقل|فہم-ادراک-بدھ۔
عقوبت|سزا-عذاب۔
عکس|پرچھائیں-غلاف-فوٹو۔
علاج|چارہکار-دفعیہ۔
علامت|نشانی-سراغ-اشارہ۔
علالت|بیماری۔
عمل|کام-مشق-قاعدہ۔
عمارت|مکان۔
عنوان|دیپاچہ-سرنامہ۔
عنقریب|جلدی-نزدیک-لگبھگ۔
عوام|عام لوگ-رعایا۔
عوارض|عارضہ کی جمع-بیماریاں۔
عہد|زمانہ-قولوقرار۔
عہدہ|مرتبہ-ملازمت-نوکری۔
عیب|قصور-برائ-عیب۔
عید|خوشی کا دن۔
عیار|فریبی-چالاک۔
غار|گڑھا-کھوہ۔
غارت|تباہی-بربادی۔
غافل|بےخبر-سست-بےپروا۔
غبن|نقصان-خیانت-خردبرد۔
غبار|مٹی والی ہوا-گھٹا۔
غبارا|ایک قسم کی آتشبازی-بیلون۔
غپی|جھوٹا-ڈنیگیں مارنے والا۔
غتربود|ملاجلا۔
غٹ|لوگوں کا ہجوم۔
غثیان|متلی-جی گھبرانا۔
غدار|دھوکےباز-بےوفا-باغی۔
غدر|بےوفائ-بلوہ-ہنگامہ-بغاوت۔
غدود|گلٹی۔
غذا|کھانا-خوراک۔
غراب|کوا۔
غرارہ|حلق میں پانی ڈال کر غرغر کر کے کلی کر دینا۔
غرض|ارادہ-خواہش۔
غرور|تکبر-گھمنڈ۔
غڑاپ|غوطہ لگانے کی آواز۔
غزا|کفار سے جنگ کرنا۔
غسل|نہان-اشنان۔
غسال|مردے کو غسل دینے والا۔
غش|بےہوشی۔
غصہ|عتاب-غضب-جھونبھل۔
غصب|چھین لینا-زبردستی حقتلفی کرنا۔
غضب|غصہ-عتاب-قہر۔
غضنفر|بہادر۔
غف|گھنا-موٹا۔
غفور|بخشنے والا۔
غفیر|بہت-لاتعداد۔
غل|شور-دھوم۔
غلاف|میان-نیام-جزدان۔
غلام|نوکر-خریدہ ہوا ملازم۔
غلبہ|زور-حملہ-زیادتی-جیت۔
غم|رنج-ملال-دکھ۔
غمگین|دکھی-اداسی۔
غمزہ|آنکھ مارنا-نازنخرہ۔
غماز|چغلخور۔
غنی|امیر-بےپروا-دولتمند۔
غنیم|دشمن-بیری-اٹیرا۔
غنیمت|لوٹ۔
غنڈا|بھڑوا-لچا-شہدا۔
غوث|مسلمانوں کا سب سے اعلی ولی۔
غور|فکر خیال-گہرابچار۔
غواض|غوطہخور۔
غول|بھوت-بھیڑ۔
غیب|پوشیدھ-غائب۔
غیبت|چغلخوری۔
غیر|اجنبی۔
غیرت|شرموحیا-لاج-رشک۔
غیریت|بیگانگی۔
فارغ|آزاد-بری-خالی۔
فائدہ|سود-نفع۔
فبہا|بہت خراب-اچھا-بہتر۔
فتح|جیت-کامیابی۔
فتنہ|ہنگامہ-فساد-جھگڑا۔
فٹ|پاوں-ایک پیمانہ بارہ انچ کا۔
فٹ پاتھ|پیدل چلنے کی جگہ۔
فجاز|برے لوگ۔
فجر|صبح سویرا۔
فحش|بیہودہ کام-بیحیائ کی باتیں۔
فجل|اونٹ-سانڈ۔
فخر|بزرگی-شرف-ناز-شیخی-گھمنڈ۔
فخری|انگور کی ایک قسم۔
فدا|قربانی-صدقہ۔
فدیہ|کفارہ-نقدمعاوضہ۔
فراز|اونچائ-بلنی۔
فرض|ضروری کام-خدا کا حکم۔
فزع|ڈر-خوف۔
فزون|زیادہ۔
فسانہ|کہانی-قصہ۔
فساد|جھگڑا-بکھیڑا-دنگا۔
فشا|نچوڑنا-دبانا۔
فشو|ہڈیاں-بیہودہ۔
فصاحت|خوش بیانی-خوش کلامی۔
فصیح|خوش بیان-خوش کلام۔
فضا|کشادگی-بہار-پرفضا۔
فضل|بزرگی-خوبی-عنایت۔
فطانت|عقلمندی-دانائ۔
فطین|دانا-چالاک۔
فعلا|عملا-عمل کی رد سے۔
فعلیا|مکار-فریبی۔
فغاں|شور-دبائ-فریاد-گریہزاری۔
فق|تعجب-حیران-پریشان۔
فقہ|علمدین-دانائ-سمجھ۔
فکر|تردد-غور-خیال۔
فک|دو ملی ہوئ چیزوں کو جدا کرنا۔
فگار|زخمی-گھائل۔
فلاح|بھلائ-بہتری۔
فلک|آسمان۔
فم|دہن-منہ۔
فن|ہنر-دستکاری۔
فنا|موت-عدم-بربادی۔
فوت|موت۔
فوج|گروہ-لشکر-مجمع۔
فہم|سمجھ-عقل-ادراک۔
فہرست|فرد-لسٹ۔
فیاض|سخی-کشادہ دل-دانا۔
فیض|فائدہ-نیکی-بھلائ۔
فرمانبردار|تابعدار۔
فرصت|مہلت۔
فرضی|خیالی-قیاس۔
قابل|لائق-ہوشیار۔
قائدہ|بنیاد-آئین-ردش-قانون۔
قامت|قد-ڈیلڈول۔
قباحت|برائ-درشتی-بدصورتی۔
قبر|گور-گڑھا-جس میں مردہ دفن کرتے ہیں۔
قبول|منظوری-تسلیم۔
قتل|خون کرنا-جان سے مار ڈالنا۔
قتلا|ٹکڑا۔
قحط|کال۔
قحبہ|رنڈی۔فاحشہ۔
قد|ڈیل-کامت۔
قدر|عزت-متبہ-درجہ۔
قدیم|پرانا۔
قرابت|رشتہ-ناطہ۔
قرض|ادھار۔
قریب|پاس-نزدیک۔
قز|کچا-ریشم۔
قزاق|لٹیرا-رہزن-بٹمار۔
قسط|حصہ-ٹکرا-بانٹ۔
قسمت|تقدیر۔
قشر|چھلکا۔
قشقون|فوج کا ایک دستہ۔
قصد|ارادہ-مطلب-مقصد۔
قصور|کمی-کوتاہی-جرم-خطا۔
قضیہ|بیان-مقدمہ-معاملہ-جھگڑا-فساد۔
قطار|صف-ترتیب-سلسلہ۔
قطرہ|بوند۔
قطع|کاٹنا۔
قطن|روئ-کپاس۔
قعر|گڑھا۔
قعود|بیٹھنا-نشست۔
قفس|پنجرا-جال-پھندا۔
قفل|تالا۔
قلب|دل۔
قلت|کمی-تھوڑا-کوتاہی۔
قلق|رنج-تکلیف-افسوس۔
قل|ختم۔
قمار|جوا۔
قمر|چاند۔
قمیض|کرتا-پیراہن۔
قناعت|صبر۔
قند|شکر-گڑ۔
قندیل|چراغدان۔
قواعد|دستور-ضوابط-آئین۔
قوت|طاقت-بل-زور۔
قول|عبارت-اقرار-عہد۔
قہر|غضب-سختی۔
قہقہہ|زور کی ہنسی۔
قیادت|رہبری کرنا۔
قیمت|دام-مول۔
قیاس|اندازہ کرنا-معاملہ کرنا-گمان-بچار۔
کافر|بےدین-ناشکرا۔
کامل|پورا۔
کبر|بڑائ-تکبر-زور۔
کبیرہ|بڑا گناہ۔
کپٹ|کمینہ-دھوکا-پاپ۔
کپاس|روئ کا پودہ-روئ۔
کتاب|لکھا ہوا۔لکھی ہوئ چیز-نوشتہ۔
کتھا|قصہ-کہانی-گفتگو۔
کٹر|بےرحم-ظالم-سخت۔
کٹھن|مشکل-سخت-تکلیف۔
کثرت|زیادتی-بہتات۔
کثافت|غلاظت-موٹائ-میلاپن۔
کج|ٹیڑھا|-ترچھا-آڑا۔
کجات|سفلہ-کمینہ۔
کچا|جو پکا نہ ہو-خام-ناقص-ناتجربہکار۔
کچلنا|دابڈالنا-مسلنا-روندنا۔
کحل|سرمہ۔
کدوکش|جدوجہد-کوشش۔
کدھر|کس طرف۔
کڈھب|بےطور-بےڈھنگ۔
کڈھنگ|بداخلاق-دشمن۔
کذاب|جھوٹا۔
کذب|جھوٹ۔
کرامت|بزرگی-خصلت-بڑھن۔
کردار|کام-فعل-ہنر۔
کڑوا|تلخ-بدمزہ-سخت-ناراض۔
کڑھن|رنج-کوفت۔
کثر|ٹیڑھا-کج۔
کثردم|بچھو-عقرب۔
کسان|کاشتکار۔
کساد|بےرونقی-بےرواجی۔
کشادہ|پھیلا ہوا-چوڑا۔
کشور|بیٹا-جوان۔
کعبہ|مربع-عمارت-مسجد جو مکہ میں ہے۔
کفالت|ذمہداری۔
کفارہ|بدلہ-گناہ کا بدلہ۔
ککڑ|مرغ۔
کگڑ|کنارہ-حاشیہ-حد۔
کل|سب-تمام-پورا۔
کلیم|کلام کرنے والا۔
کم|تھوڑا-چھوٹا۔
کمزور|ناطاقت-ناتواں۔
کنر|سست-کاہل۔
کنجی|چابی۔
کوچہ|گلی-آگ۔
کورٹ|عدالت۔
کونا|گوشہ-راہ-طرف۔
کہا|قول-بات-نصیحت۔
کہانی|قصہ-داستان۔
کیپ|ٹوپی۔
کینہ|حسد-بغض۔
گاڑھ|دشواری-مشقل۔
گال|رخسار۔
گائید|راہ دیکھانے والا۔
گھبرو|خاوند-شوہر۔
گپ|بکواس-لغویات۔
گپت|چھپا-پوشیدہ۔
گت|حالت-طرح-حرکت۔
گٹ|غل۔
گٹھا|جوڑنا-بندھنا۔
گجرا|کلائ کا زیور-پھولوں کا ہار۔
گجگجانا|آواز کرنا۔
گچھا|بنڈل۔
گچ|اوکھلی-پکافرش-پلاسٹر۔
گدا|بھکاری-فقیر۔
گدھاپن|بےوقوفی۔
گڈریا|گوالا-چرواہا۔
گڈی|بنڈل-گٹھڑی۔
گذارش|عرض-بیان۔
گذشتہ|گذرا ہوا۔
گردن|گلا۔
گروہ|جھنڈ-غول۔
گرفت|پکڑ-قبضہ۔
گرد|خاک-دھول۔
گڑھ|قلعہ۔
گزاف|بکواس-شیخی۔
گزند|نقصان-صدمہ۔
گستاخی|بےادبی۔
گستر|بچھانے والا-پھیلانے والا۔
گستہ|ٹوٹا ہوا۔
گشت|پھرنا-سیر کرنا۔
گفتگو|بولچال۔
گگن|آسمان۔نہایت اونچا۔
گل|پھول۔
گلی|تنگ کوچہ۔
گم|دور-غائب-عیرحاضر۔
گمان|شبہ-ظن-غرور۔
گمنام|نامعلوم-پوشیدہ۔
گن|جوہر-ہنر-فن۔
گنت|ریاضی-حساب۔
گندم|گیہوں۔
گنوار|دہقان-ناشائستہ۔
گنہگار|پاپی-قصوروار-مجرم۔
گواہی|شہادت۔
گود|آغوش۔
گودام|ذخیرہ۔
گھاٹ|دریا کا کنارہ-نہانے کی جگہ۔
گھائل|زخمی۔
گھورنا|تاکنا۔
گیت|بھجن۔
گیند|بال۔
گیان|علمواقفیت۔
لاتعداد|بےشمار-انگنت۔
لاٹری|قرعہاندازی۔
لباس|پوشاک-کپڑے۔
لبرل|آزاد۔
لپڑی|پگڑی-دستار۔
لپٹ|لو-گرمی-آنچ-خوشبو-مہک۔
لت|عادت-چسکا۔
لتپت|نتھڑا ہوا۔
لٹیرا|رہزن-چور-بٹمار۔
لٹریری|علم ادب۔
لجا|شرم-حیا۔
لجاو|شرمیلا۔
لچا|بدمعاش-اوباش۔
لچک|جھکاو-نزاکت سے حرکات۔
لحاظ|حیا-خیال-توجہ۔
لحیم|موٹا۔
لخت|ٹکڑا-پارہ۔
لڈو|مٹھائ کا نام۔
لذت|مزا-ذائقہ۔
لذیذ|مزیدار۔
لرزش|کپکپی۔
لڑائ|جنگ-جھگڑا-فساد۔
لزوم|لازم ہونا۔
لسان|زبان-بولی۔
لسی|دودھ اور پانی کا مرکب۔
لشکر|فوج۔
لطافت|نرمی-نزاکت-صفائ۔
لطیفہ|چٹکلا۔
لعنت|پھٹکار۔
لعاب|تھوک-رال۔
لغت|فرہنگ-ڈکشنری-بولی۔
لغز|پہیلی۔
لفظ|کامہ-شبد۔
لفافہ|کاغذ کا تھیلا جس میں خط وغیرہ بند کیا جاتا ہے۔
لقب|وہ نام جو کسی وصف کے سبب مشہور ہوجاۓ۔
لقمہ|نوالہ۔
لکچر|تقریر۔
لکڑی|چوب-سونٹا-چھڑی۔
لکیر|لائن-حد-سطر۔
لگ|قریب-آسپاس۔
لگاو|تعلق-محبت۔
لگاتار|متواتر۔
لگی|خواہش-آرزو-محبت۔
للو|زبان-بولچال۔
لمبا|طویل-دراز-بڑا۔
لمع|روشنی-چمک۔
لنک|پابند-ڈھیڑ۔
لو|گرم ہوا۔
لواحق|رشتہدار۔
لہو|خون۔
لیبل|چٹ۔
مات|شکست-ہار۔
مال|دولت۔
مبارک|برکت والا-خوش قسمت۔
مباحات|فخر-بڑائ-شانوشوکت۔
مپان|مقدار-پیمانہ۔
متعدد|بیشمار-بہت-کئ۔
متین|پکا-سنجیدہ-وزنی۔
مٹاپا|جسم کا موٹا ہونا۔
مٹھاس|شیرینی-میٹھاپن۔
مثال|نظیر-مانند-تمثیل-نمونہ۔
مثبت|ثابت کیا ہوا۔
مجال|طاقت-قدرت-قابو۔
مجبور|لاچار-بےبس۔
مچلنا|رونا-ضد کرنا-اڑی کرنا۔
محاصل|آمدنی-فائدہ-نفع۔
محبت|اخلاص-پیار۔
مخاطب|خطاب کرنے والا-کلام کرنے والا۔
مختلف|جدا-الگ۔
مدت|عرصہ-زمانہ۔
مدد|سہارا۔
مڈل|درمیانہ۔
مذہب|دین-طریقہ-راہ۔
مرض|بیماری۔
مرگ|موت۔مزا|ذائقہ-لذت۔
مزاج|طبیعت-عادت۔
مژدہ|خوشخبری۔
مژہ|پلک۔
مسافر|فر کرنے والا۔
مسکن|رہنے کی جگہ-گھر-مکان۔مشغلہ|کام-تفریح-کھیل۔
مشققت|محنت۔
مصنف|تصنیف کرنے والا۔
مصیبت|تکلیف-دکھ۔
مضبوط|سخت-پکا۔
مضمون|مطلوب-بیان۔
مطالبہ|تقاضا کرنا-مانگنا۔
مطمین|تسلی والا-بےفکر۔
مظالم|بےانصافیاں۔
مظفر|کامیاب-فتحمند۔
معافی|بخشش۔
معروف|مشہور۔
مغرور|گھمنڈی-متکبر۔
مفاد|فائدہ۔
مقام|ٹھہرنے کی جگہ۔
مکمل|پورا-کامل۔
ملال|رنجیدگی-اداسی۔
ممنون|احسانمند۔
منصوبہ|ارادہ-قصد۔
موجب|سبب-باعث-وجہ۔
مہاجر|ہجرت کرنے والا۔
میانہ|درمیانہ۔
میوہ|پھا-ثمر-بار۔
نام|اسم-شہورت۔
نامور|مشہور۔
نبی|پیغمبر-رسول۔
نثار|قربان-نچھاور۔
نجات|رہائ-چھٹکارا۔
ندامت|شرمندگی۔
ندی|نہر-دریا-نالہ۔
نڈر|بےخوف۔
نرالا|انوکھا-عجب-اچھاکام۔
نرم|ملائم۔
نزاکت|نازکپن۔
نزدیک|قریب۔
نس|رگ۔
نسبت|تعلق-مشابہت۔
نسل|خاندان-اولاد۔
نشونما|بڑھنا-ترقی پانا۔
نصر|قتح-مدد۔
نصف|آدھا۔
نصیب|قسمت۔
نضارت|تازگی۔
نظارہ|دیکھنا-سیر کرنا۔
نظر|نگاہ-دید۔
نعرہ|آواز-شہرت۔
نعمت|برکت-عمدہ۔
نعوذ|پناہ۔
نعیم|خوشی-نفع-نعمت۔
نغمہ|راگ-سرود۔
نغز|عجیب-خوبصورت-عودہ۔
نفرت|گھن-حقارت-کراہت۔
نفع|فائدہ۔
نفیس|صاف۔
نقاب|گھونگٹ-پردہ۔
نقش|چھاپ۔
نقصان|ٹوٹا-خسارہ۔
نکاح|شادی۔
نگہت|خوشبو-مہک۔
نگاہ|نظر-دیدد-مشاہدہ۔
نگہبان|محافظ-نگراں۔
نم|تر-گیلا-بھیگا۔
نماز|عاجزی-مسلمانوں کی عبادت۔
نمایاں|ظاہر-آشکار۔
نمبر|گنتی-تعداد۔
نور|روشنی-چمک۔
نوع|قسم-طرح۔
نوکر|ملازم۔
نہار|صبح۔
نہال|خوشوخرم۔
نہایت|آخر-انجام-بہت۔
نیت|ارادہ۔
نیشن|قوم۔
نیک|اچھا-بھلا۔
واجب|ضروری-لازم-فرض۔
واٹر|پانی۔
وبال|سختی-مصیبت-بوجھ۔
وثوق|استواری-اعتماد-استقلال۔
وجاہت|عزت۔
وجہ|سبب۔
وچار|سوچ-خیال۔
وحدت|تنہائ-اکیلا ہونا۔
وحشت|خوف-نفرت۔
وداع|رخصت۔
ودیا|علم۔
ورثہ|مرنے والے کا مال۔
ورم|سوجن۔
وزن|تول-بوجھ-اندازہ۔
وزر|گناہ-جرم-بوجھ۔
وسط|بیچ-درمیان۔
وسیلہ|ذریعہ۔
وشواس|یقین۔
وصف|تعریف-بیان۔
وصول|پہنچنا-ملنا-حاصل۔
وضاحت|واضح کرنا۔
وظیفہ|ہر روز کا ورد-تنخواہ۔
وعدہ|قول-قرار-عہد۔
وغا|لڑائ-جنگ۔
وفات|موت-مر جانا۔
وفا-اعتبار۔
وقار|عزت۔
وقفہ|ٹھراو-رکنا-کچھ دیر۔
وکیل|نائب-وکالت کرنے والا۔
ولادت|پیدائش۔
ولد|باپ۔
ون|رہنے کی جگہ-چشمہ-جنگل۔
ووٹ|راۓ۔وہاں|اس جگہ۔
وہم|گمان-خیال۔
ویر|بیر-دشمنی۔
ویران|اجاڑہ-تباہ-خراب۔
ویلکم|خوشآمدید۔
ولی|خدا کا خاص بندہ-دوست۔
وقائع|حادثے-واقعات۔
وقت|سماں-موقہ-زمانہ۔
وقر|مرتبہ-عزت۔
وشال|وسیع۔
وساطت|وسیلہ-ذریعہ۔
وزنی|بھاری۔
وزن|اٹھانے میں بھاری۔
وردھ|مخالفت-مقابلہ۔
وجع|درد۔
واقفیت|علمیت-تجربہ-علم۔
والدین|ماں باپ۔
واسطہ|تعلق۔
ہاٹ|بازار-دوکان۔
ہار|شکست-تھکاوٹ۔
ہال|بڑا کمرہ۔
ہبڑا|بدشکل-بھدا۔
ہبہ|بخشش۔
ہت|دوستی-محبت۔
ہتھیار|آلہ-اوزار۔
ہٹی|دوکان۔
ہٹانا|دور کرنا۔
ہجرت|جدائ-علیحدگی۔
ہجوم|جماعت-بھیڑ۔
ہچکا|دھکا۔
ہدایت|رہنمائ-رہبری-حکم-ارشاد۔
ہدف|نشانہ۔
ہدیہ|انعام-تحفہ۔
ہذیان|بکواس-فضول گفتگو۔
ہربار|ہردفعہ۔
ہراس|خوف-در۔
ہردم|ہروقت۔
ہرگز|بالکل۔
ہڑبڑی|گھبراہٹ۔
ہزال|مسخرا۔
ہزل|بےہودہ۔
ہستی|زندگی-موجودگی۔
ہسکا|نقل-رشک۔
ہکابکا|حیران۔
ہکلا|جو رک رک کر بات کرتا ہے۔
ہکلانا|رک رک کر بوانا۔
ہلا|شوروغل۔
ہلاک|مارنا-قتل۔
ہلکا|کم وزن۔
ہمدم|گہرا دوست۔
ہمت|دلیری۔
ہمدردی|درد میں شریک ہونا-غمخواری۔
ہمسایہ|پڑوسی۔
ہموار|برابر-یکساں-ایک جیسا۔
ہمہ|تمام-سب۔
ہمیشہ|سدا۔
ہنر|جوہر-لیاقت-فن۔
ہنگامہ|شوروغل-لڑائ۔
ہوٹل|کھانا کھانے کی جگہ۔
ہوس|خواہش-لالچ۔
ہوش|سمجھ-عقل۔
ہوم|گھر۔
ہونٹ|لب۔
ہونہار|لائق-مشہور۔
ہامی|یقین-صدقہ-ذمہ۔
ہست|وجود۔
ہامون|جنگل-بیابان۔
یار|دوست-محبوب۔
یاور|مددگار۔
یثرب|مدینہ کا پہلا نام۔
یخ|برف-ٹھنڈا۔
ید|ہاتھ۔
یراق|لڑائ کا سامان۔
یرقان|ایک بیماری۔
یزدان|اللہ تعالی۔
یسرآسانی|دولتمند۔
یساق|مہم-تیاری جنگ کی۔
یسار|بائیں ہاتھ-دولت۔
یعنی|مراد-مطلب۔
یغما|لوٹ-غنیمت۔
یقین|اعتبار-بھروسہ۔
یک|ایک۔
یکایک|دفعتہ-فورا-اچانک۔
یکم|پہلا۔
یکساں|برابر-ایک جیسا۔
یگ|پوجہ-قربانی۔
یگانگت|رشتہداری۔
یل|پہلوان-بہادر۔
یلدار|اندھیری اور بڑی رات۔
یلغار|حملہ۔
یم|موت کا فرشتہ۔
یمن|برکت-عربی شہر۔
یمین|دایاں-سیدھا۔
ینگ|جوان-چھوٹا۔
یورش|حملہ-دھاوا۔
یوم|دن۔یونیورسٹی|دارالعلوم-جامعہ۔
